#################
#  X         XO #
#     O      ####
#              O#
###########   X #
#      O  #     #
#         # #   #
#   X     PVOX  #
#         ##  X #
#         O###  #
#################
