############
#       XO #
#  P    ####
#          #
######     #
# O  #     #
#    #     #
#          #
#       X  #
#       #  #
############
