#################
#               #
#            ####
#               #
###########     #
#         #     #
#         # #   #
#         P  XO #
#         ##    #
#          ###  #
#################
