#####
#   #
# XP# ###
# XX# #O#
### ###O#
 ##    O#
 ##     #
 #   #  #
 #   ####
 #####
