 ####
##  #
# PX#
##X ##
## X #
#OX  #
#OOVO#
######
