  ######
  #    #
###XXX #
#P XOO #
# XOOO##
####  #
   ####
