 ####
 #P ###
 # X  #
### # ##
#O# #  #
#OX  # #
#O   X #
########
